{
  "name": "Generated_veteran_3058",
  "difficulty": "veteran",
  "width": 24,
  "height": 14,
  "tiles": [
    "########################",
    "#..#T..E#E#...##..#.#..#",
    "#.#......#.E#..........#",
    "#..#.#..#.......#......#",
    "#....#.....E#..#E..#...#",
    "#E.....T....T.##....#..#",
    "#..#.....#.#......#..###",
    "#.#.##...####.#.#..#.#.#",
    "####..ST.T..##..#......#",
    "#.#..##..E..E#......#..#",
    "##E....#..T........#...#",
    "#..#....#.#...##E.#...##",
    "#....#...#..#...#...X..#",
    "########################"
  ]
}
