{
  "name": "Generated_easy_9338",
  "difficulty": "easy",
  "width": 12,
  "height": 8,
  "tiles": [
    "############",
    "#..#.E.....#",
    "#.S...T....#",
    "#....TE....#",
    "#...EXT.#..#",
    "#....#E.##.#",
    "#.........##",
    "############"
  ]
}
